############
#....*.....#
#..1..2.+..#
#..........#
############
