############
#..1...~~..#
#......~~..#
#..2.......#
############
