############
#...1......#
#..+....+..#
#..........#
############
