########################
#....==......==........#
#....==......==........#
#....==......==........#
#....==......==........#
#....==......==........#
#..............~~~~~...#
#..............~~~~~...#
#......................#
########################
