############
#..........#
#..T....B..#
#..1.......#
############
