####################
#......1...........#
#.................##
#..######..........#
#.................##
####################
