############################################################
#..........................................................#
#.::::::::::::::....;;;;;;;;;;,;;;....::::::::::::::.......#
#.::::::::::::::....;;;;;;;;;;,;;;....::::::::::::::.......#
#.::::::::::::::....;;;;;;;;;;,;;;....::::::::::::::.......#
#.::::::::::::::....;;;;;;;;;;,;;;....::::::::::::::.......#
#.::::::::::::::....;;;;;;;;;;,;;;....::::::::::::::.......#
#.::::::::::::::....;;;;;;;;;;,;;;....::::::::::::::.......#
#.............................,............................#
#.............................,............................#
#.,,,,,,,,,,,,,,,,,,,,,,,,,,,,,,,,,,,,,,,,,,,,,,,,,,,,,,,,.#
#.,,,,,,,,,,,,,,,,,,,,,,,,,,,,,,,,,,,,,,,,,,,,,,,,,,,,,,,,.#
#.,,,,,,,,,,,,,,,,,,,,,,,,,,,,,,,,,,,,,,,,,,,,,,,,,,,,,,,,.#
#.............................,............................#
#.............................,............................#
#.;;;;;;;;;;;;;;;;;;;;;;;;..::,:::::::::::::::::::::::::::.#
#.;;;;;;;;;;;;;;;;;;;;;;;;..::,:::::::::::::::::::::::::::.#
#.;;;;;;;;;;;;;;;;;;;;;;;;..::,:::::::::::::::::::::::::::.#
#.;;;;;;;;;;;;;;;;;;;;;;;;..::,:::::::::::::::::::::::::::.#
#.;;;;;;;;;;;;;;;;;;;;;;;;..::,:::::::::::::::::::::::::::.#
#.;;;;;;;;;;;;;;;;;;;;;;;;..::,:::::::::::::::::::::::::::.#
#.;;;;;;;;;;;;;;;;;;;;;;;;..::,:::::::::::::::::::::::::::.#
#..........................................................#
############################################################
