############################################################
#,,,,,,,,,,,,,,,;,,,,,,,,,,,,,,,,,,,,,,;,,,,,,,,,,,,,,,,,,,#
#,##############,,,,##############,,,,##############,,,;,,,#
#,#,,,,,,,,,,,,#,,,,#,,,,;,,,,,,,#,,,,#,,,,,,,,,;,,#,,,,,,,#
#,#,,,,,,,,,,,,#,,;,#,,,,,,,,,,,,#,,,,#,,;,,,,,,,,,#,,,,,,,#
#,#,,,,,,,,;,,,#,,,,#,,,,,,,,,,,,#;,,,#,,,,,,,,,,,,#,,,,,;,#
#,#,;,,,,,,,,,,#,,,,#,,,,,,;,,,,,#,,,,#,,,,,,,,,,,;#,,,,,,,#
#,##############,,,,##############,,,,##############,,,,,,,#
#,########################################################,#
#,#,,,;,,,,,,,,,,,,,,,,,,,,,,;,,,,,,,,,,,,,,,,,,,,,,;,,,,#,#
#,#,,,,,,,,,,,,,,,,,,,;,,,,,,,,,,,,,,,,,,,,,,;,,,,,,,,,,,#,#
#,#,,,,,,,,,,,,;,,,,,,,,,,,,,,,,,,,,,,;,,,,,,,,,,,,,,,,,,#,#
#,#,,,,,;,,,,,,,,,,,,,,,,,,,,,,;,,,,,,,,,,,,,,,,,,,,,,;,,#,#
#;#,,,,,,,,,,,,,,,,,,,,,;,,,,,,,,,,,,,,,,,,,,,,;,,,,,,,,,#,#
#,########################################################,#
#,########################,,##############################,#
#,#;,,,,,,,,,,,,,,,,,,,,,#;,#,,,,,,,,,,,,,,,,,,,,;,,,,,,,#,#
#,#,,,,,,,,,,,,,,,,;,,,,,#,,#,,,,,,,,,,,,,;,,,,,,,,,,,,,,#,#
#,#,,,,,,,,,;,,,,,,,,,,,,#,,#,,,,,,;,,,,,,,,,,,,,,,,,,,,,#;#
#,#,,;,,,,,,,,,,,,,,,,,,,#,,#,,,,,,,,,,,,,,,,,,,,,,;,,,,,#,#
#,#,,,,,,,,,,,,,,,,,,;,,,#,,#,,,,,,,,,,,,,,,;,,,,,,,,,,,,#,#
#,########################,,##############################,#
#,,,,,,;,,,,,,,,,,,,,,,,,,,,,,;,,,,,,,,,,,,,,,,,,,,,,;,,,,,#
############################################################
