############################################################
#,,,,,,,,,,,,,,,;,,,,,,,,,,,,,,,,,,,,,,;,,,,,,,,,,,,,,,,,,,#
#,,,,,,,,;,,,,,,,,,,,,,,,,,,,,,,;,,,,,,,,,,,,,,,,,,,,,,;,,,#
#,;,,,,,,,,,,,,,,,,,,,,,,;,,,,,,,,,,,,,,,,,,,,,,;,,,,,,,,,,#
#,,,,,,,,,,,,,,,,,;,,,,,,,,,,,,,,,,,,,,,,;,,,,,,,,,,,,,,,,,#
#,,,,,,,,,,;,,,,,,,,,,,,,,,,,,,,,,;,,,,,,,,,,,,,,,,,,,,,,;,#
#,,,;,,,,,,,,,,,,,,,,,,,,,,;,,,,,,,,,,,,,,,,,,,,,,;,,,,,,,,#
#,,,,,,,,,,,,,,,,,,,;,,,,,,,,,,,,,,,,,,,,,,;,,,,,,,,,,,,,,,#
#,,,,,,,,,,,,;,,,,,,,,,,,,,,,,,,,,,,;,,,,,,,,,,,,,,,,,,,,,,#
#,,,,,;,,,,,,,,,,,,,,,,,,,,,,;,,,,,,,,,,,,,,,,,,,,,,;,,,,,,#
#,,,,,,,,,,,,,,,,,,,,,;,,,,,,,,,,,,,,,,,,,,,,;,,,,,,,,,,,,,#
#,,,,,,,,,,,,,,;,,,,,,,,,,,,,,,,,,,,,,;,,,,,,,,,,,,,,,,,,,,#
#,,,,,,,;,,,,,,,,,,,,,,,,,,,,,,;,,,,,,,,,,,,,,,,,,,,,,;,,,,#
#;,,,,,,,,,,,,,,,,,,,,,,;,,,,,,,,,,,,,,,,,,,,,,;,,,,,,,,,,,#
#,,,,,,,,,,,,,,,,;,,,,,,,,,,,,,,,,,,,,,,;,,,,,,,,,,,,,,,,,,#
#,,,,,,,,,;,,,,,,,,,,,,,,,,,,,,,,;,,,,,,,,,,,,,,,,,,,,,,;,,#
#,,;,,,,,,,,,,,,,,,,,,,,,,;,,,,,,,,,,,,,,,,,,,,,,;,,,,,,,,,#
#,,,,,,,,,,,,,,,,,,;,,,,,,,,,,,,,,,,,,,,,,;,,,,,,,,,,,,,,,,#
#,,,,,,,,,,,;,,,,,,,,,,,,,,,,,,,,,,;,,,,,,,,,,,,,,,,,,,,,,;#
#,,,,;,,,,,,,,,,,,,,,,,,,,,,;,,,,,,,,,,,,,,,,,,,,,,;,,,,,,,#
#,,,,,,,,,,,,,,,,,,,,;,,,,,,,,,,,,,,,,,,,,,,;,,,,,,,,,,,,,,#
#,,,,,,,,,,,,,;,,,,,,,,,,,,,,,,,,,,,,;,,,,,,,,,,,,,,,,,,,,,#
#,,,,,,;,,,,,,,,,,,,,,,,,,,,,,;,,,,,,,,,,,,,,,,,,,,,,;,,,,,#
############################################################
