########################################################################################################################
#,,,,,,,,,,,,,,,,,,,,,,,,,,,,,,,,,,,,,,,,,,,,,,,,,,,,,,,,,,,,,,,,,,,,,,,,,,,,,,,,,,,,,,,,,,,,,,,,,,,,,,,,,,,,,,,,,,,,,,#
#,##############,,,,##############,,,,##############,,,,#########################,,,,,,,,,,,,,,,,,,,,,,,,,,,,,,,,,,,,,,#
#,#............#,,,,#............#,,,,#............#,,,,#.......................#,,,,,,,,,,,,,,,,,,,,,,,,,,,,,,,,,,,,,,#
#,#............#,,,,#............#,,,,#............#,,,,#.......................#,,,,,,,,,,,,,,,,,,,,,,,,,,,,,,,,,,,,,,#
#,#............#,,,,#............#,,,,#............#,,,,#.......................#,,,,,,,,,,,,,,,,,,,,,,,,,,,,,,,,,,,,,,#
#,#............#,,,,#............#,,,,#............#,,,,#.......................#,,,,,,,,,,,,,,,,,,,,,,,,,,,,,,,,,,,,,,#
#,#####  #######,,,,######  ######,,,,#######  #####,,,,#########    ############,,,,,,,,,,,,,,,,,,,,,,,,,,,,,,,,,,,,,,#
#,,,,,;::;,,,,,,,,,,,,,,,;::;,,,,,,,,,,,,,,,;::;,,,,,,,,;;;;;;;;;::::;;;;;;;;;;;;,,,,,,,,,,,,,,,,,,,,,,,,,,,,,,,,,,,,,,#
#,,,,,,::,,,,,,,,,,,,,,,,,::,,,,,,,,,,,,,,,,,::,,,,,,,,,;;;;;;;;;::::;;;;;;;;;;;;,,,,,,,,,,,,,,,,,,,,,,,,,,,,,,,,,,,,,,#
#,,,,,,::::::::::::::::::::::::::::::::::::::::::::::::::::::::::::::::::::::::::::::::::,,,,,,,,,,,,,,,,,,,,,,,,,,,,,,#
#,,,,,,::::::::::::::::::::::::::::::::::::::::::::::::::::::::::::::::::::::::::::::::::,,,,,,,,,,,,,,,,,,,,,,,,,,,,,,#
#,,,,,,,,,,,,,,,,::::,,,,,,,,,,,,,,,,,,,,,,,,,,,,,,,,,,,::,,,,,,,,,,,,,,,,,,,,,,,,,,,,,,,,,,,,,,,,,,,,,,,,,,,,,,,,,,,,,#
#,,,,,,,,,,,,,,,,::::,,,,,,,,,,,,##########,,,,,,,,,,###  ##############,,,,,,,,,,,,,,,,,,,,,,,,,,,,,,,,,,,,,,,,,,,,,,,#
#,,,,,,,,,,,,,,,,::::,,,,,,,,,;;;#........#,,,,,,,,,,#.................#,,,,,,,,,,,,,,,,,,,,,,,,,,,,,,,,,,,,,,,,,,,,,,,#
#,,,;;;;;;,,,,,,,::::,,,,,,,,,;;;#........#,,,,,,,,,,#.................#,,,,,,,,,,,,,,,,,,,,,,,,,,,,,,,,,,,,,,,,,,,,,,,#
#,,,;;;;;;,,,,,,,::::,,,,,,,,,;;;#........#,,,,,,,,,,#.................#,,,,,,,,,,,,,,,,,,,,,,,,,,,,,,,,,,,,,,,,,,,,,,,#
#,,,;;;;;;,,,,,,,:::::::::::::::: ........#,,,,,,,,,,#.................#,,,,,,,,,,,,,,,,,,,,,,,,,,,,,,,,,,,,,,,,,,,,,,,#
#,,,;;;;;;,,,,,,,:::::::::::::::: ........#,,,,,,,,,,#.................#,,,,,,,,,,,,,,,,,,,,,,,,,,,,,,,,,,,,,,,,,,,,,,,#
#,,,;;;;;,,,,,,,,::::,,,,,,,,,;;;#........#,,,,,,,,,,###################,,,,,,,,,,,,,,,,,,,,,,,,,,,,,,,,,,,,,,,,,,,,,,,#
#,,,;;;;;,,,,,,,,::::,,,,,,,,,;;;#........#,,,,,,,,,,,,,,,,,,,,,,,,,,,,,,,,,,,,,,,,,,,,,,,,,,,,,,,,,,,,,,,,,,,,,,,,,,,,#
#,,,;;;;;,,,,,,,,::::,,,,,,,,,;;;#........#,,,,,,,,,,,,,,,,,,,,,,,,,,,,,,,,,,,,,,,,,,,,,,,,,,,,,,,,,,,,,,,,,,,,,,,,,,,,#
#,,,,,,,,,,,,::::::::,,,,,,,,,,,,##########,,,,,,,,,,,,,,,,,,,,,,,,,,,,,,,,,,,,,,,,,,,,,,,,,,,,,,,,,,,,,,,,,,,,,,,,,,,,#
#,,,,,,,,,,,,::::::::,,,,,,,,,,,,,,,,,,,,,,,,,,,,,,,,,,,,,,,,,,,,,,,,,,,,,,,,,,,,,,,,,,,,,,,,,,,,,,,,,,,,,,,,,,,,,,,,,,#
#,,,,,,,,,,,,::::,,,,,,,,,,,,,,,,,,,,,,,,,,,,,,,,,,,,,,,,,,,,,,,,,,,,,,,,,,,,,,,,,,,,,,,,,,,,,,,,,,,,,,,,,,,,,,,,,,,,,,#
#,,,,,,,,,,,,::::,,,,,,,,,,,,,,,,,,,,,,,,,,,,,,,,,,,,,,,,,,,,,,,,,,,,,,,,,,,,,,,,,,,,,,,,,,,,,,,,,,,,,,,,,,,,,,,,,,,,,,#
#,,,;;;;;;,,,::::,,,,;;;;;;;,,,,,,,,,,,,,,,,,,,,,,,,,,,,,,,,,,,,,,,,,,,,,,,,,,,,,,,,,,,,,,,,,,,,,,,,,,,,,,,,,,,,,,,,,,,#
#,,,;;;;;;,,,::::,,,,;;;;;;;,,,,,,,,,,,,,,,,,,,,,,,,,,,,,,,,,,,,,,,,,,,,,,,,,,,,,,,,,,,,,,,,,,,,,,,,,,,,,,,,,,,,,,,,,,,#
#,,,;;;;;;,,,::::,,,,;;;;;;;,,,,,,,,,,,,,,,,,,,,,,,,,,,,,,,,,,,,,,,,,,,,,,,,,,,,,,,,,,,,,,,,,,,,,,,,,,,,,,,,,,,,,,,,,,,#
#,,,;;;;;;,,,::::,,,,;;;;;;;,,,,,,,,,,,,,,,,,,,,,,,,,,,,,,,,,,,,,,,,,,,,,,,,,,,,,,,,,,,,,,,,,,,,,,,,,,,,,,,,,,,,,,,,,,,#
#,,,;;;;;;,,,::::,,,,,,,,,,,,,,,,,,,,,,,,,,,,,,,,,,,,,,,,,,,,,,,,,,,,,,,,,,,,,,,,,,,,,,,,,,,,,,,,,,,,,,,,,,,,,,,,,,,,,,#
#.,.,.,.,.,.,::::,.,.,.,.,.,.,.,.,.,.,.,.,.,.,.,.,.,.,.,.,.,.,.,.,.,.,.,.,.,.,.,.,.,.,.,.,.,.,.,.,.,.,.,.,.,.,.,.,.,.,.#
#......................................................................................................................#
#......................................................................................................................#
#......................................................................................................................#
#......................................................................................................................#
#----------------------------------------------------------------------------------------------------------------------#
#----------------------------------------------------------------------------------------------------------------------#
#----------------------------------------------------------------------------------------------------------------------#
#----------------------------------------------------------------------------------------------------------------------#
#----------------------------------------------------------------------------------------------------------------------#
#----------------------------------------------------------------------------------------------------------------------#
#----------------------------------------------------------------------------------------------------------------------#
#----------------------------------------------------------------------------------------------------------------------#
#----------------------------------------------------------------------------------------------------------------------#
#----------------------------------------------------------------------------------------------------------------------#
#----------------------------------------------------------------------------------------------------------------------#
########################################################################################################################
