############################################################
#,,,,,,,,,,,,,,,;,,,,,,,,,,,,,,,,,,,,,,;,,,,,,,,,,,,,,,,,,,#
#,##############,,,,##############,,,,##############,,,;,,,#
#,#,,,,,,,,,,,,#,,,,#,,,,;,,,,,,,#,,,,#,,,,,,,,,;,,#,,,,,,,#
#,#,,,,,,,,,,,,#,,;,#,,,,,,,,,,,,#,,,,#,,;,,,,,,,,,#,,,,,,,#
#,#,,,,,,,,;,,,#,,,,#,,,,,,,,,,,,#;,,,#,,,,,,,,,,,,#,,,,,;,#
#,#,;,,,,,,,,,,#,,,,#,,,,,,;,,,,,#,,,,#,,,,,,,,,,,;#,,,,,,,#
#,##############,,,,##############,,,,##############,,,,,,,#
#,,,,,,,,,,,,,,,,,,,,,,,,,,,,,,,,,,,,,,,,,,,,,,,,,,,,,,,,,,#
#,,,,,;,,,,,,,,,,,,,,,,,,,,,,;,,,,,,,,,,,,,,,,,,,,,,;,,,,,,#
#,,,,,,,,,,,,,,,,,,,,,;,,,,,,,,,,,,,,,,,,,,,,;,,,,,,,,,,,,,#
#,,,,,,,,,,,,,,;,,,,,,,,,,,,,,,,,,,,,,;,,,,,,,,,,,,,,,,,,,,#
#,,,,,,,;,,,,,,,,,,,,,,,,,,,,,,;,,,,,,,,,,,,,,,,,,,,,,;,,,,#
#;,,,,,,,,,,,,,,,,,,,,,,;,,,,,,,,,,,,,,,,,,,,,,;,,,,,,,,,,,#
#,,,,,,,,,,,,,,,,,,,,,,,,,,,,,,,,,,,,,,,,,,,,,,,,,,,,,,,,,,#
#,########################,,##############################,#
#,#;,,,,,,,,,,,,,,,,,,,,,#;,#,,,,,,,,,,,,,,,,,,,,;,,,,,,,#,#
#,#,,,,,,,,,,,,,,,,;,,,,,#,,#,,,,,,,,,,,,,;,,,,,,,,,,,,,,#,#
#,#,,,,,,,,,;,,,,,,,,,,,,#,,#,,,,,,;,,,,,,,,,,,,,,,,,,,,,#;#
#,#,,;,,,,,,,,,,,,,,,,,,,#,,#,,,,,,,,,,,,,,,,,,,,,,;,,,,,#,#
#,#,,,,,,,,,,,,,,,,,,;,,,#,,#,,,,,,,,,,,,,,,;,,,,,,,,,,,,#,#
#,########################,,##############################,#
#,,,,,,;,,,,,,,,,,,,,,,,,,,,,,;,,,,,,,,,,,,,,,,,,,,,,;,,,,,#
############################################################
