############################################################
#,,,,,,,,,,,,,,,;,,,,,,,,,,,,,,,,,,,,,,;,,,,,,,,,,,,,,,,,,,#
#,#,############,,,,#,############,,,,#,############,,,;,,,#
#,#,,,,,,,,,,,,#,,,,#,,,,;,,,,,,,#,,,,#,,,,,,,,,;,,#,,,,,,,#
#,#,,,,,,,,,,,,#,,;,#,,,,,,,,,,,,#,,,,#,,;,,,,,,,,,#,,,,,,,#
#,#,,,,,,,,;,,,#,,,,#,,,,,,,,,,,,#;,,,#,,,,,,,,,,,,#,,,,,;,#
#,#,;,,,,,,,,,,#,,,,#,,,,,,;,,,,,#,,,,#,,,,,,,,,,,;#,,,,,,,#
#,##############,,,,##############,,,,##############,,,,,,,#
#,,,,,,,,,,,,,,,,,,,,,,,,,,,,,,,,,,,,,,,,,,,,,,,,,,,,,,,,,,#
#,,,,,;,,,,,,,,,,,,,,,,,,,,,,;,,,,,,,,,,,,,,,,,,,,,,;,,,,,,#
#,,,,,,,,,,,,,,,,,,,,,;,,,,,,,,,,,,,,,,,,,,,,;,,,,,,,,,,,,,#
#,,,,,,,,,,,,,,;,,,,,,,,,,,,,,,,,,,,,,;,,,,,,,,,,,,,,,,,,,,#
#,,,,,,,;,,,,,,,,,,,,,,,,,,,,,,;,,,,,,,,,,,,,,,,,,,,,,;,,,,#
#;,,,,,,,,,,,,,,,,,,,,,,;,,,,,,,,,,,,,,,,,,,,,,;,,,,,,,,,,,#
#,,,,,,,,,,,,,,,,,,,,,,,,,,,,,,,,,,,,,,,,,,,,,,,,,,,,,,,,,,#
#,#,######################,,#,############################,#
#,#;,,,,,,,,,,,,,,,,,,,,,#;,#,,,,,,,,,,,,,,,,,,,,;,,,,,,,#,#
#,#,,,,,,,,,,,,,,,,;,,,,,#,,#,,,,,,,,,,,,,;,,,,,,,,,,,,,,#,#
#,#,,,,,,,,,;,,,,,,,,,,,,#,,#,,,,,,;,,,,,,,,,,,,---------#;#
#,#,,;,,,,,,,,,,,,,,,,,,,#,,#,,,,,,,,,,,,,,,,,,,---------#,#
#,#,,,,,,,,,,,,,,,,,,;,,,#,,#,,,,,,,,,,,,,,,;,,,---------#,#
#,########################,,##############################,#
#,,,,,,;,,,,,,,,,,,,,,,,,,,,,,;,,,,,,,,,,,,,,,,,----------,#
############################################################
