############################################################
#,,,,,,,,,,,,,,,;,,,,,,,,,,,,,:,,,,,,,,;,,,,,,,,,,,,,,,,,,,#
#,..............,,,,..............,,,,..............,,,;,,,#
#,..............,,,,..............,,,,..............,,,,,,,#
#,..............,,;,..............,,,,..............,,,,,,,#
#,..............,,,,..............;,,,..............,,,,,;,#
#,..............,,,,..............,,,,..............,,,,,,,#
#,..............,,,,..............,,,,..............,,,,,,,#
#,........................................................,#
#,........................................................,#
#:........................................................:#
#:........................................................:#
#:........................................................:#
#;........................................................,#
#,........................................................,#
#,........................,,..............................,#
#,........................;,..............................,#
#,........................,,..............................,#
#,........................,,..............................;#
#,........................,,..............................,#
#,........................,,..............................,#
#,........................,,..............................,#
#,,,,,,;,,,,,,,,,,,,,,,,,,,,,,:,,,,,,,,,,,,,,,,,,,,,,;,,,,,#
############################################################
