############################################################
############################################################
############################################################
###............######............######............#########
###....*.......######....S.......######......K.....#########
###............######............######............#########
###............######............######............#########
#########.#################.#################.##############
#########.#################.##.##############.##############
###......................................................###
###......................................................###
###......................................................###
###......................................................###
###......................................................###
##############.###############.############.################
##############.############################.################
###......................####............................###
###.....T................####.............B..............###
###...............B......####............................###
###......................####............................###
###......................####............................###
############################################################
############################################################
############################################################
